WWWWWWWWWWWWWWWWWWWW
WWBBWBBBBBBBBBBBBBWW
WB  B             BW
WB  B          B  BW
WB       WW     B BW
WB       WW       BW
WB                BW
WB  B     B       BW
WB  B    P B      BW
WWWWWWWWWWWWWWWWWWWW