╭──────────────────╮
│ BB BBBBBBBBBBBBB │
│B  B             B│
│B  B          B  B│
│B       ╭╮     B B│
│B       ╰╯       B│
│B                B│
│B  B     B       B│
│B  B    P B      B│
╰──────────────────╯