WWWWWWWWWWWWWWWWWWWW
WWBBWBBBBBBBBBBBBBWW
WB  B             BW
WB  B          B  BWWWWWWWWWWWWWWWWWWWWWWWW
WB       WW     B BWWWWWWBBBBBBBBBBBBBBBBBW
WB       WW                               W
WB                         BB BBBBB BB    W
WB  B     B       BWWWWWB                 W
WB  B    P B      BW   WB      WW         W
WWWWWWWWWWWWWWWWWWWW   WB      WW         W
                       WB      BBBB B     W
                       WB  B        B     W
                       WB                 W
                       WWWWWWWWWWWWWWWWWWWW